tileswide 16
tileshigh 12
tilewidth 40
tileheight 40

layer 0
1,1,1,1,1,1,1,1,1,1,1,1,1,1,1,1,
1,0,0,0,0,0,0,0,0,0,0,0,0,0,0,1,
1,0,0,0,0,0,0,0,0,0,0,0,0,0,0,1,
1,0,0,0,0,0,0,0,0,0,0,0,0,0,0,1,
1,0,0,0,0,0,0,0,0,0,0,0,0,0,0,1,
1,1,0,0,1,1,1,1,1,1,1,1,0,0,1,1,
1,0,0,0,0,0,0,0,0,0,0,0,0,0,0,1,
1,1,0,0,1,1,1,1,1,1,1,1,0,0,1,1,
1,0,0,0,0,0,0,0,0,0,0,0,0,0,0,1,
1,1,0,0,1,1,1,1,1,1,1,1,0,0,1,1,
1,0,0,0,0,0,0,0,0,0,0,0,0,0,0,1,
1,1,1,1,1,1,1,1,1,1,1,1,1,1,1,1,

